████████████████████████████████████████████████████████████████████████████████
██      ███     ██████████████   █         █   ███     ████ ████       ██      █
██ ████ ███████ ██████████████ █ █ █████████ █     ███ ████ ████ █████    ████ █
██ █         ██              █ █ █ █████████ █ ███████      ████ █████████████ █
██ █ ███████ ██ ████████████ █ ███ █████████ █ ███     █████████ █    █    █   █
█  █    ██   ██         ████ █ ███           █   █ █████████████ ████   ████ ███
██ ███████ ████████████ ████ █ ███████████ █████ █ ███           ███████████ ███
██ ██                   ████             █ █     █ ███ █ ██████████████      ███
██ ██  █████████████████████████████████ █ ███████     █ ████████    ██ ████████
██ ██         █████ ████████████████████   ███     █████ ████████ ██ ██ ████████
██ █████████  █████                    ███████ ████████████       ██          ██
██     ██ ██  █   █ ██████████████ ███ ███████ ████   █████ ████████████████████
██████ ██ ██  █████ ████████████ █ █ █ ███████      █ ██    ██      ███ ████████
██████ ██ ██      █ ██         █ █   █       ████████ ██ ██████ ███ ███ ████████
█      ██ █████ █ █ ██ █████████ █████ █████ █        ██        ███ ███        █
█ ███████ ██    █   ██ █       █       █████ █  ████████ ██████████ ███ ███ ████
█ ██████████ █████████ █ █████   ███████████ ███████████ ██ ████ ██         ████
█ █                    █ █ ███████           █     █  ██ ██ ████ ██ ███████ ████
█ ██ ███████ ███████████   █     █████████████ █ ███  ██ ██████████ ███████ ████
█ ██ ███   █ █ █       █████ ███████  ████ █ █ █ █ █  █  █  ███  ██ █     █    █
█ ██   █   ███ █ ████  █ ███ █    ██  ████ █ █ █ █ ████ ███     ███ █ ███ ██████
█ ████ ██████████████  █ ███ █ █  ████████     █ █ ████ █████████████ ███      █
█   ██          ██  █    ███ ███  ██████████████ ██████               ████████ █
███ ███████████ ██  ████████                     █████████████████████████████ █
███         ███     ████████████  ██████████████                               █
████████████████████████████████████████████████████████████████████████ ███████
